I'm the teapot_不詳.mid
I've been working on the railroad_不詳.mid
hictory dickory dock_不詳.mid
humpty dumpty_不詳.mid
merrily we roll along_不詳.mid
six little ducks_不詳.mid
skip to my lou_不詳.mid
the farmer in the dell_不詳.mid
wheels on the bus_不詳.mid
yankee doodle_不詳.mid
ten little indians: 十個印第安人_不詳.mid
pedicab: 三輪車_不詳.mid
little donkey: 小毛驢_不詳.mid
trinkle twinkle little star: 小星星_不詳.mid
little teapot: 小茶壺_不詳.mid
flying train: 火車快飛_不詳.mid
mr old wang has a piece of land: 王老先生有塊地_不詳.mid
mother is the best in the world: 世上只有媽媽好_不詳.mid
as long as I grow up: 只要我長大_不詳.mid
happy birthday: 生日快樂_不詳.mid
words by westerly: 西風的話_不詳.mid
two tigers: 兩隻老虎_不詳.mid
tomorrow will be better: 明天會更好_不詳.mid
clay doll: 泥娃娃_不詳.mid
aunt tiger: 虎姑婆_不詳.mid
great wall ballad: 長城謠_不詳.mid
dance of youth: 青春舞曲_不詳.mid
autumn cicada: 秋蟬_不詳.mid
jasmine: 茉莉花_不詳.mid
london bridge is falling down: 倫敦鐵橋垮下來_不詳.mid
fishing song: 捕魚歌_不詳.mid
catch the loach: 捉泥鰍_不詳.mid
green high mountain: 高山青_不詳.mid
sweet family: 甜蜜的家庭_不詳.mid
fish swimming in water: 魚兒魚兒水中游_不詳.mid
oh susanna: 喔，蘇珊娜_不詳.mid
childhood: 童年_張艾嘉.mid
duckweed together: 萍聚_李翊君.mid
when we are together: 當我們同在一起_不詳.mid
song of a wanderer: 遊子吟_不詳.mid
green oil: 綠油精_不詳.mid
song of splashing water: 潑水歌_不詳.mid
butterfly: 蝴蝶_不詳.mid
snail and oriole: 蝸牛與黃鸝鳥_銀霞.mid
lulala: 魯啦啦_不詳.mid
descendants of the dragon: 龍的傳人
lazy bug: 懶惰蟲
happy days: 歡樂年華_不詳.mid
